92,92,92,92,92,92,92,92,92,92,92,92,92,92,32,32,32,32,31,32,32,32,32,32,32,32,32,32,32,32,32,32,32,32,32,32,32,32,32,32,32,32,32,33,32,32,32,32,32,32,32,92,92,92,92,92,92,92,92,92,32,32,32,32,32,32,32,32,32,32,32,32,32,32,32,32,32,32,32,92,92,92,92,92,31,32,32,33,92,92,92,92,92,92,92,92,92,92,92,92,92,92,92,92,92,92,92,92,32,32,32,32,32,32,32,32,32,32,32,32,32,32,32,32,32,32,32,32,32,32,32,32,32,32,32,32,32,32,32,32,32,32,32,32,32,32,32,32,32,32,32,32,32,32,32,32,32,32,31,32
92,92,92,92,92,92,92,92,92,92,92,92,240,32,32,32,32,32,31,32,32,32,32,32,32,32,32,32,32,32,32,32,32,32,32,32,32,32,32,32,32,32,32,33,32,32,32,32,32,32,32,92,92,92,92,92,92,92,92,92,32,32,32,32,32,32,32,32,32,32,32,32,32,32,32,32,32,32,32,92,92,92,92,92,31,32,32,33,92,92,92,92,92,92,25,26,92,92,92,92,92,240,92,92,92,92,92,92,32,32,32,32,32,32,32,32,32,32,240,32,32,32,32,32,32,32,240,32,32,32,32,32,32,32,32,240,32,240,32,32,32,32,32,32,32,32,32,32,32,32,240,32,32,32,32,32,32,32,31,32
92,32,32,32,32,92,92,92,92,92,92,92,240,32,32,32,32,32,31,32,32,32,32,32,32,32,32,32,32,32,32,32,32,32,32,32,32,32,32,32,32,32,32,33,32,32,32,240,32,32,32,32,92,92,92,92,92,240,92,32,32,32,32,32,32,32,32,32,240,32,32,32,32,32,32,32,32,32,32,92,92,92,92,92,31,32,32,33,92,92,92,92,92,92,40,41,92,92,92,92,92,240,92,92,92,92,92,32,32,32,32,32,92,92,32,32,32,32,240,32,32,32,32,32,32,32,240,32,32,32,32,32,32,32,32,32,32,32,32,32,32,32,32,32,32,32,32,32,32,32,240,32,32,32,32,32,32,32,31,32
92,32,32,32,32,32,32,92,92,92,240,32,32,91,17,17,17,17,107,47,47,47,47,47,50,32,32,32,32,32,32,32,32,32,32,32,32,32,32,32,32,32,32,33,32,32,32,240,32,32,32,32,32,92,92,92,92,240,92,32,32,32,32,32,32,32,32,32,240,32,32,32,32,32,32,32,32,244,32,92,92,92,92,92,31,32,32,33,92,92,92,92,92,92,92,92,92,92,92,92,92,92,76,17,17,17,17,77,17,17,17,17,17,17,17,17,17,78,32,32,32,32,32,32,32,32,32,76,17,17,17,17,17,17,18,242,242,242,16,17,17,17,17,17,17,17,77,17,17,78,32,32,32,32,32,32,32,32,31,32
92,92,92,92,92,92,92,92,92,92,240,32,32,32,32,32,32,32,32,32,32,32,32,32,31,32,32,32,32,32,32,32,32,32,32,32,32,32,32,32,32,32,32,33,32,32,32,32,91,17,17,17,17,17,17,17,93,92,92,32,32,32,32,32,32,32,32,32,32,76,17,17,17,17,17,17,17,17,17,77,17,17,17,17,35,32,32,33,92,92,240,92,92,92,92,92,92,92,92,240,92,92,31,32,32,32,32,32,32,32,32,32,32,32,32,32,32,33,32,32,32,32,32,32,240,32,32,31,32,32,32,32,32,32,36,17,17,17,35,32,32,32,32,32,32,32,32,32,32,33,32,32,32,32,32,32,32,32,31,32
77,17,17,17,17,17,17,17,17,78,32,32,32,32,32,32,32,32,32,32,32,32,32,32,31,32,32,32,32,32,32,32,32,32,32,32,32,32,32,32,32,32,32,33,32,32,32,32,32,32,32,32,92,92,92,92,92,92,92,240,32,32,32,32,32,32,32,32,32,31,32,32,32,32,32,32,32,32,32,32,32,32,32,32,32,32,32,33,92,92,240,92,92,92,92,92,92,92,92,240,92,92,106,47,47,47,50,32,32,32,32,32,32,32,32,32,32,33,32,32,32,32,32,32,240,32,32,106,47,47,47,47,47,47,47,107,47,47,47,47,47,47,47,47,47,47,47,47,47,108,32,32,32,32,32,32,32,32,31,32
32,32,32,32,32,32,32,32,32,33,92,92,240,92,92,92,92,92,92,92,92,240,32,32,106,47,47,47,47,47,47,107,47,47,47,47,47,47,47,47,47,47,47,108,32,32,32,32,32,32,32,32,32,92,92,92,92,92,92,240,32,32,32,32,32,32,32,32,32,31,32,32,32,32,32,32,32,32,32,32,32,32,32,32,32,32,32,33,92,92,92,76,17,17,17,17,17,17,78,92,92,92,92,92,92,92,31,32,32,32,32,32,32,32,32,32,32,36,17,17,17,17,17,78,32,32,32,32,32,32,32,32,32,32,32,33,32,32,32,32,32,32,32,32,32,32,32,32,32,32,32,32,32,32,32,32,32,32,31,32
107,47,47,47,47,47,47,47,47,108,92,92,92,92,92,92,32,32,92,92,92,92,92,92,32,32,32,32,32,32,32,32,32,32,32,32,32,32,32,32,32,32,32,92,32,32,32,32,32,32,32,32,32,32,32,92,92,92,92,92,76,17,17,17,17,17,17,17,17,35,32,32,32,32,32,32,32,32,32,32,32,32,32,32,32,32,32,33,92,92,92,31,92,92,92,92,92,92,33,92,92,92,92,92,92,92,31,32,32,32,32,32,32,32,32,32,32,32,32,32,32,32,32,33,32,32,32,32,32,32,32,32,32,32,32,33,32,32,32,32,32,32,32,32,32,32,32,32,32,32,32,32,32,32,32,32,32,32,31,32
92,92,92,92,92,92,92,92,92,92,92,92,92,91,17,17,17,17,17,17,93,92,92,92,32,92,92,240,240,92,92,92,32,32,32,32,32,32,32,32,32,32,32,92,240,32,32,32,32,32,32,240,32,32,32,32,32,32,92,92,31,32,32,32,32,32,32,32,32,32,32,32,32,32,32,32,32,32,32,32,32,32,32,32,32,32,32,33,92,92,92,106,47,47,47,47,47,47,108,92,92,92,92,92,92,242,31,32,32,32,32,32,32,32,32,32,32,32,32,32,32,32,32,33,32,32,32,32,32,32,32,32,32,32,32,33,32,32,32,32,32,32,32,32,32,32,32,32,32,32,32,32,32,32,32,32,32,32,31,32
92,92,92,92,92,92,92,92,92,92,92,92,92,32,32,32,32,32,32,32,92,92,32,92,92,92,92,32,32,92,92,92,92,32,32,32,32,32,32,32,32,32,32,32,240,32,32,32,32,32,32,240,32,32,32,32,32,92,92,92,31,32,32,32,32,32,32,32,32,32,32,32,32,32,32,32,32,32,32,32,32,32,32,32,32,32,32,33,92,92,92,92,92,92,92,92,92,92,92,92,92,92,76,17,17,17,35,32,32,32,32,32,32,32,32,32,32,32,32,32,32,32,32,36,17,17,17,17,17,17,17,17,17,17,17,93,32,32,32,32,32,32,32,32,32,32,32,32,32,32,32,32,32,32,32,32,32,32,31,32
92,244,92,92,92,92,92,92,92,92,92,92,92,92,92,92,92,92,92,92,92,92,92,92,76,17,18,242,242,16,17,77,17,17,17,17,17,17,17,17,17,17,17,78,32,32,32,32,32,32,32,32,76,17,17,17,17,17,17,17,35,32,32,32,32,32,32,32,32,32,32,32,32,32,32,32,32,32,32,32,32,32,32,32,32,32,32,33,92,92,240,92,92,92,92,92,92,92,92,240,92,92,31,32,32,32,32,32,32,32,32,32,32,32,32,32,32,32,32,32,32,32,32,32,32,32,32,32,32,32,32,92,92,32,32,33,32,32,32,32,32,32,32,32,32,32,32,32,32,32,32,32,32,32,32,32,32,32,31,32
77,17,17,17,17,17,17,17,17,78,32,92,92,92,92,92,92,92,240,92,92,92,92,32,31,92,36,17,17,35,92,92,92,92,92,92,92,92,92,92,92,92,92,33,92,92,92,92,92,240,32,32,31,92,92,92,92,32,32,32,32,32,32,32,32,32,32,32,32,32,32,32,32,32,32,32,32,32,32,32,32,32,32,32,32,32,32,33,92,92,240,92,92,92,92,92,92,92,92,240,92,92,106,47,47,47,50,32,32,32,32,32,32,32,32,32,32,32,32,32,32,32,32,32,32,32,32,32,32,32,32,92,92,32,92,33,32,32,32,32,32,32,32,32,32,32,32,32,32,32,32,32,32,32,32,32,32,32,31,32
92,92,92,92,92,92,92,92,92,33,32,32,32,32,92,92,92,32,240,32,32,32,92,32,31,92,92,92,92,92,92,92,92,92,92,92,92,92,92,92,92,92,92,33,92,92,92,92,92,240,92,92,106,47,47,47,47,47,47,47,107,47,47,47,47,47,47,47,47,47,47,47,47,47,47,47,47,47,47,47,47,47,47,47,47,47,47,108,32,32,32,76,17,17,17,17,17,17,78,92,92,92,92,92,92,92,31,32,32,32,32,32,32,32,32,32,32,32,32,32,32,32,32,32,32,32,32,32,32,32,32,92,92,92,92,33,32,32,32,32,32,32,32,32,32,32,32,32,32,32,32,32,32,32,32,32,32,32,31,32
92,92,92,92,92,92,92,92,92,33,32,32,32,32,32,92,92,92,92,76,17,17,17,17,35,92,92,92,92,92,92,92,92,92,92,92,92,92,92,92,92,92,92,36,17,17,17,17,78,92,92,92,92,92,32,92,92,92,92,92,92,92,92,92,32,32,32,32,32,32,32,32,32,32,32,32,32,32,32,32,32,32,32,32,32,92,92,92,92,92,92,31,92,92,92,92,92,92,33,92,92,92,92,92,92,92,31,32,32,32,32,32,32,32,32,32,32,32,32,32,32,32,32,32,32,32,32,32,32,32,32,92,32,32,32,33,32,32,32,32,32,32,32,32,32,32,32,32,32,32,32,32,32,32,32,32,32,32,31,32
92,92,92,92,92,92,92,92,92,33,32,32,32,32,240,92,92,92,32,31,92,92,92,92,92,92,92,92,92,92,92,92,92,92,92,92,92,92,92,92,92,92,92,92,92,92,92,32,33,92,92,92,92,92,92,92,92,92,92,92,92,92,92,32,32,32,32,32,32,32,32,32,32,32,240,32,240,32,32,32,32,32,32,32,32,92,92,92,240,92,92,106,47,47,47,47,47,47,108,92,92,92,92,92,92,242,31,32,32,32,32,32,32,32,32,32,32,32,32,32,32,32,32,32,32,32,32,32,32,32,32,92,92,32,32,33,32,32,32,32,32,32,32,32,32,32,32,32,32,32,32,32,32,32,32,32,32,32,106,47
92,92,92,92,92,92,92,92,92,33,92,92,92,92,240,32,32,92,92,31,92,92,92,92,92,92,92,92,92,92,92,92,92,92,92,92,92,92,92,92,92,92,92,92,92,92,92,32,33,92,92,92,92,92,92,92,92,92,92,92,92,92,92,92,32,32,32,32,32,32,32,32,32,32,32,32,32,32,32,32,32,32,32,32,32,92,92,92,92,92,92,92,92,92,92,92,92,92,92,92,92,92,76,17,17,17,35,32,32,32,32,32,32,32,32,32,32,32,32,32,32,32,32,32,32,32,32,32,32,32,32,92,92,92,32,36,17,17,17,78,32,32,32,32,32,32,32,32,32,32,32,32,32,32,32,32,32,32,92,32
92,92,92,92,92,92,92,92,92,33,92,92,92,92,92,76,17,17,17,35,92,92,92,92,92,92,92,92,92,92,92,92,92,92,92,92,92,92,92,92,92,92,92,92,92,92,92,32,36,17,17,17,17,17,17,17,17,17,17,17,77,17,17,17,17,17,17,17,17,17,17,17,17,18,242,242,242,16,17,17,17,17,17,17,17,17,17,78,92,92,92,92,92,92,92,92,92,92,92,92,92,92,31,92,92,92,92,32,32,32,32,32,32,32,32,32,32,32,32,32,32,32,32,32,32,32,32,32,32,32,32,92,92,32,32,32,92,32,32,33,32,32,32,32,32,32,32,32,32,32,32,32,32,32,32,32,32,32,92,32
92,92,92,92,92,92,92,92,92,33,32,92,92,92,92,31,92,92,92,92,92,92,92,92,92,92,92,92,92,92,92,92,92,92,92,92,92,92,92,92,92,92,92,92,92,92,92,32,92,92,92,92,92,92,92,92,92,92,92,92,92,92,92,92,32,32,32,32,32,32,32,32,32,36,17,17,17,35,32,32,32,32,32,32,32,32,32,33,92,92,92,92,92,92,92,92,92,92,92,92,92,92,31,92,92,92,92,32,32,32,32,32,32,32,32,32,32,32,32,32,32,32,32,32,32,32,32,32,32,32,32,32,92,92,32,32,32,32,32,33,32,32,32,32,32,32,32,32,32,32,32,32,32,32,32,32,32,32,92,92
92,92,92,92,92,92,92,92,92,36,17,17,17,17,17,35,92,92,92,92,92,92,92,92,92,92,92,92,92,92,92,92,92,92,92,92,92,92,92,92,92,92,92,92,92,92,92,32,92,92,92,92,92,92,92,92,92,92,92,92,92,92,92,92,32,32,32,32,32,32,32,32,32,32,32,32,32,32,32,32,32,32,32,32,32,32,32,36,17,17,17,17,17,17,17,17,17,17,17,17,17,17,35,92,92,92,92,32,32,32,32,32,32,32,32,32,32,32,32,32,32,32,32,32,32,32,32,32,32,32,32,32,92,92,32,32,32,32,92,36,17,17,17,17,17,17,17,17,17,17,17,17,17,17,17,17,17,17,77,17
92,92,92,92,92,92,92,92,92,32,32,32,32,32,32,32,32,32,92,92,92,92,92,92,92,92,92,92,92,92,92,92,92,92,92,92,92,92,92,92,92,92,92,92,92,92,92,32,92,92,92,92,92,92,92,92,92,92,92,92,92,92,92,92,92,92,32,32,32,32,32,32,32,32,32,32,32,32,32,32,32,32,32,32,32,32,32,92,92,92,92,92,92,92,92,92,92,92,92,92,92,92,92,92,92,92,92,32,32,32,32,32,32,32,32,32,32,32,32,32,32,32,32,32,32,32,32,32,32,32,32,32,92,92,92,92,92,92,92,92,92,92,92,92,92,92,92,92,92,92,92,92,92,92,92,92,92,92,92,92
